 
CN  ADESANYA                 Adeyemi         ASD DAT -   ADESANYA@CERNVM.CERN.CH                                                            
CN  BEREJNOI                 Vladimir        ASD DAT -   BEREZHNOI@VXCERN.CERN.CH                                                           
CN  CREMEL                   Nicole-Laurence ASD DAT -   CREMEL@CERNVM.CERN.CH                                                              
CN  NATHANIEL                Alfred          ASD DAT -   NATHANIE@CERNVM.CERN.CH                                                            
CN  COUET                    Olivier         ASD DAT SL  couet@hphigz.cern.ch                                                               
CN  KOZLOVSKY                Gregory         ASD DAT -   KLY@CERNVM.CERN.CH                                                                 
CN  RADEMAKERS               Fons            ASD DAT -   rdm@cernvm.cern.ch                                                                 
CN  VASSILOPOULOU            Fofi            ASD DB  -   FOFI@DXCERN.CERN.CH                                                                
CN  DELAMARE                 Catherine       ASD DB  -   CATERINE@CERNVM.CERN.CH                                                            
CN  SANTIAGO                 Sergio          ASD DB  SL  SANTIAGO@CERNVM.CERN.CH                                                            
CN  DOMINGUEZ-SOL            Jorge           ASD DB  -   JDOMSOL@DXCERN.CERN.CH                                                             
CN  SEGURA-CHINCHILLA        Nilo            ASD DB  -   NILO@CERNVM.cern.ch                                                                
CN  SHERING                  George          ASD DB  -   SHERING@ps.msm.CERN.CH                                                             
CN  MONTUELLE                Jean            ASD DB  -   Montuel@cernvm.cern.ch                                                             
CN  FERRAN                   Genny           ASD DB  -   GENNY@CERNVM.CERN.CH                                                               
CN  BRUN                     Rene            ASD DI  -   BRUN@CERNVM.CERN.CH                                                                
CN  OSBORNE                  Tony            ASD DI  GL  TONYO@CERNVM.CERN.CH                                                               
CN  GOOSSENS                 Michel          ASD DI  -   goossens@cernvm.cern.ch                                                            
CN  RAVNDAL                  Sven            ASD DI  -   RAVNDAL@CERNVM.CERN.CH                                                             
CN  METCALF                  Michael         ASD PAR SL  METCALF@CERNVM.CERN.CH                                                             
CN  BESSON                   Lysiane         ASD PL  -   BESSON@CERNVM.CERN.CH                                                              
CN  DIPOTET                  Perfecto        ASD PL  -   perfecto@vxcern.cern.ch                                                            
CN  FAIN                     Valeri          ASD PL  -   fine@vxcern.cern.ch                                                                
CN  BINKO                    Pavel           ASD PL  -   BINKO@CERNVM.CERN.CH                                                               
CN  BARNETT                  Ingrid          ASD PL  -   BARNETT@CERNVM.CERN.CH                                                             
CN  VANDONI                  Carlo           ASD PL  -   VANDONI@CERNVM.CERN.CH                                                             
CN  SHIERS                   Jamie           ASD PL  DGL JAMIE@CERNVM.CERN.CH                                                               
CN  FOLGER                   Gunter          ASD PL  -   GUNTER@DXCERN.cern.ch                                                              
CN  JAMES                    Frederick       ASD PL  -   james@cernapo.cern.ch                                                              
CN  KOLBIG                   Kurt-Siegfried  ASD PL  -   KSK@CERNVM.CERN.CH                                                                 
CN  MCLAREN                  Ian             ASD PL  -   MCLARENI@CERNVM.CERN.CH                                                            
CN  PEREVOZTCHIKOV           Victor          ASD SI  -   PEREV@VXCERN.CERN.CH                                                               
CN  GRICHINE                 Vladimir        ASD SI  -   None                                                                               
CN  VUOSKOSKI                Jouko           ASD SI  -   jvuoskos@dxcern.cern.ch                                                            
CN  LASSILA-PERINI           Katri           ASD SI  -   KATI@CERNVM.CERN.CH                                                                
CN  GIANI                    Simone          ASD SI  SL  SGIANI@cernvm.cern.ch                                                              
CN  MARTUCCI                 Pietro-Paolo    CE  AE  -   martucci@sunpietro.cern.ch                                                         
CN  MARQUIS                  Alain           CE  AE  -   MARQUIS@CERNVM.CERN.CH                                                             
CN  OROPESA-HERNANDEZ        Julio           CE  AE  -   OROPESA@VXCERN.CERN.CH                                                             
CN  ZURBUCHEN                Rudi            CE  AE  SL  ZURDJ@CERNVM.CERN.CH                                                               
CN  ZSENEI                   Marton          CE  CA  -   ZSENEI@VXENG.CERN.CH                                                               
CN  FERRAN                   Mik             CE  CA  -   pmfdj@cernvm.cern.ch                                                               
CN  BOCH                     Guy             CE  CA  -   GBOCH@VXENG.CERN.CH                                                                
CN  DACH                     Miroslaw        CE  CA  -   dach@suca01.cern.ch                                                                
CN  HOIMYR                   Nils-Joar       CE  CA  -   nils@cadd.cern.ch                                                                  
CN  MASSO                    Sebastian       CE  CA  -   MASSOS@CERNVM.CERN.CH                                                              
CN  TATE-LAVERGNE            Monique         CE  CA  -   TATE@CERNVM.CERN.CH                                                                
CN  SEIS                     Irene           CE  CA  -   SEIS@VXENG.CERN.CH                                                                 
CN  PROTOULIS-DALMAZ         Ketty           CE  CA  -   PRO@CERNVM.CERN.CH                                                                 
CN  MESSERLI                 Roland          CE  CA  SL  MESSERLI@VXENG.CERN.CH                                                             
CN  HOWIE                    James-Michael   CE  CA  -   HOWIE@VXENG.CERN.CH                                                                
CN  PATCHEN                  Gary            CE  DC  -   patchen@dsy-srv3.cern.ch                                                           
CN  THYS                     Antoine         CE  DC  -   THYS@DXCERN.CERN.CH                                                                
CN  MARAIS                   Odette          CE  DC  -   MARAIS@CERNVM.CERN.CH                                                              
CN  COUTURIER                Michel          CE  DC  -   COUTURIE@CERNVM.CERN.CH                                                            
CN  SOSO                     Fabio           CE  DC  -   SOSO@CERNVM.CERN.CH                                                                
CN  ZUMBROCK                 Karl            CE  DC  -   GTM@CERNVM.CERN.CH                                                                 
CN  BAEHLER                  Pierre          CE  DC  DGL baehler@dsy-srv3.cern.ch                                                           
CN  BOSCO                    Nicola          CE  DC  -   BOSCO@CERNVM.CERN.CH                                                               
CN  MANENT                   Michel          CE  DC  -   manent@dsy-srv3.cern.ch                                                            
CN  BROBECKER                Serge           CE  DC  -   SERGE@dxcern.CERN.CH                                                               
CN  ECK                      Christoph       CE  DI  GL  CEC@dxcern.CERN.CH                                                                 
CN  MORENO-PENA              Maria-Lourdes   CE  MS  -   LMORENO@DSY-SRV3.CERN.CH                                                           
CN  BLAKE                    Julian          CE  MS  -   BLAKE@dxcern.CERN.CH                                                               
CN  MERKEL                   Martin          CE  MS  -   martinm@cernvm.cern.ch                                                             
CN  VAN-DER-VLUGT            Christian       CE  MS  -   kwibus@dxcern.CERN.CH                                                              
CN  PREGERNIG                Ludwig          CE  MS  SL  LFP@CERNVM.CERN.CH                                                                 
CN  KEMP                     Douglas         CE  MS  -   KEMP@dxcern.CERN.CH                                                                
CN  IGO-KEMENES              Judit           CE  MS  -   JIK@CERNVM.CERN.CH                                                                 
CN  TOQUERO                  Belen           CE  PC  -   TOQUERO@CN.MSM.CERN.CH                                                             
CN  FLOCKHART                Bruce           CE  PC  SL  RBF@cn.msm.cern.ch                                                                 
CN  PERON                    Daniel          CE  PC  -   PEROND@CERNVM.CERN.CH                                                              
CN  HAWKINS                  Matthew         CE  PC  -   HAWKINS@CN.MSM.CERN.CH                                                             
CN  SAINSON                  Jean-Michel     CE  PC  -   SAIN@CERNVM.CERN.CH                                                                
CN  BAKER                    Stephen         CIO DI  -   SBSCT@CERNVM.CERN.CH                                                               
CN  PARROTT                  Andrew          CIO DI  -   PARROTT@CERNVM.CERN.CH                                                             
CN  HANSEN                   Claus           CIO DI  -   celsborg@cernvm.cern.ch                                                            
CN  BAIKIE                   Philip          CIO DI  -   pbaikie@cernvm.cern.ch                                                             
CN  TREVISANI                Fabio           CIO DI  -   TFABIO@CERNVM.CERN.CH                                                              
CN  VOSDEY                   Jean-Louis      CIO DI  -   JLVCT@CERNVM.CERN.CH                                                               
CN  UNDERHILL                David           CIO DI  GL  DJUCT@CERNVM.CERN.CH                                                               
CN  JOUBERJEAN               Franck          CIO DI  -   FJJ@CERNVM.CERN.CH                                                                 
CN  GARD                     Italo           CIO DI  -   IGA@CERNVM.CERN.CH                                                                 
CN  SCHWARZBAUER             Hannes          CIO DI  -   SCHWARZY@CERNVM.CERN.CH                                                            
CN  BOUVRY                   Remy            CIO DI  -   BOV@CERNVM.CERN.CH                                                                 
CN  BLANC                    Michel          CIO DI  -   MJBCT@CERNVM.CERN.CH                                                               
CN  TRONES                   Jostein-Lodve   CO  RE  -   TRONES@DXCERN.CERN.CH                                                              
CN  ANTHONIOZ-BLANC          Jacques         CS  CH  -   jab@dxcern.cern.ch                                                                 
CN  COLLIGNON                Marc            CS  CH  -   COLLIGNO@VXCERN.CERN.CH                                                            
CN  QUATAERT                 Philippe        CS  CH  -   quataert@dxcoms.cern.ch                                                            
CN  ROCHEZ                   Jacques         CS  CH  -   rochez@uxcsb1.cern.ch                                                              
CN  JOOSTEN                  Joop            CS  CH  SL  jmj@dxcoms.cern.ch                                                                 
CN  FUTO                     Endre           CS  CH  -   FUTO@CERNVM.CERN.CH                                                                
CN  CARPENTER                Brian           CS  DI  GL  Brian@dxcoms.cern.ch                                                               
CN  FLUCKIGER                Francois        CS  DI  DGL FLUCKIGER@VXCERN.CERN.CH                                                           
CN  MONNET                   Marie-Therese   CS  DI  -   MONNET@CERNVM.cern.ch                                                              
CN  MARTEL                   Cecile          CS  EN  -   cmartel@dxcoms.cern.ch                                                             
CN  AASE                     Sven            CS  EN  -   AASE@dxcoms.CERN.CH                                                                
CN  GALVEZ                   Philippe        CS  EN  -   pgalvez@dxcoms.cern.ch                                                             
CN  JOUANIGOT                Jean-Michel     CS  EN  -   jimi@dxcoms.cern.ch                                                                
CN  HEAGERTY                 Denise          CS  EN  -   DENISE@DXCOMS.CERN.CH                                                              
CN  MARTIN                   Olivier-Herve   CS  EN  SL  MARTIN@CEARN.cern.ch                                                               
CN  DIMOU                    Maria           CS  EN  -   dimou@dxcoms.cern.ch                                                               
CN  ALTABER                  Jacques         CS  EN  -   JLA@dxcoms.cern.ch                                                                 
CN  OGILVIE                  John            CS  EN  -   ogilvie@uxcsb1.cern.ch                                                             
CN  ISNARD                   Christian       CS  EN  -   ISNARD@DXCOMS.CERN.CH                                                              
CN  PARMENTIER               Laurence        CS  IN  -   LPA@DXCERN.CERN.CH                                                                 
CN  MORONI                   Paolo           CS  IN  -   MORONI@CERNVM.CERN.CH                                                              
CN  GERARD                   Mike            CS  IN  -   JMG@dxcoms.CERN.CH                                                                 
CN  GAMBLE                   John-Nigel      CS  IN  SL  GAMBLE@VXCERN.CERN.CH                                                              
CN  FLEISCHMANN              Manfred         CS  IN  -   MAF@CERNVM.CERN.CH                                                                 
CN  DAVIDS                   Daniel          CS  IN  -   danny@dxcoms.cern.ch                                                               
CN  ROSS                     Alasdair        CS  NO  -   ABRCT@CERNVM.CERN.CH                                                               
CN  SMYRIS                   George          CS  NO  SL  SMY@CERNVM.CERN.CH                                                                 
CN  ER-RGHIOUI               Aziz            CS  NO  -   eraziz@nextcnco.cern.ch                                                            
CN  CANNON                   Stanley         CS  TS  -   CANNON@CERNVM.CERN.CH                                                              
CN  DA-COSTA                 Maryse          CS  TS  -   MARYSE@CERNVM.CERN.CH                                                              
CN  FLUCKIGER                Martin          CS  TS  -   FLE@VXCERN.CERN.CH                                                                 
CN  GENTET                   Claudine        CS  TS  -   CGE@CERNVM.CERN.CH                                                                 
CN  MERTINA                  Claude          CS  TS  -   MERTINA@CERNVM.CERN.CH                                                             
CN  SOHET                    Leopold         CS  TS  SL  SOHET@CERNVM.CERN.CH                                                               
CN  SIMEONI                  Jean            CS  TS  -   JSI@CERNVM.CERN.CH                                                                 
CN  PLATTEAUX                Raoul           CS  TS  -   PLA@CERNVM.CERN.CH                                                                 
CN  GELISSEN                 Paulus          CS  TS  -   GELISSEN@CERNVM.CERN.CH                                                            
CN  HARDAKER                 Pamela          DCI ACT -   PAMELA@VSCN08.CERN.CH                                                              
CN  MARQUINA                 Miguel          DCI ACT SL  MARQUINA@CERNVM.CERN.CH                                                            
CN  KOPPANYI                 Attila          DCI ACT -   ATTILA@CERNVM.CERN.CH                                                              
CN  FRANCESCHI               Michel          DCI ACT -   FRANCES@CERNVM.CERN.CH                                                             
CN  GENTILE                  Maurizio        DCI ACT -   GENTILM@CERNVM.CERN.CH                                                             
CN  WOOLNOUGH                Roger           DCI ACT -   ROGER@CERNVM.CERN.CH                                                               
CN  POLLERMANN               Bernd           DCI ACT -   BERND@CERNVM.CERN.CH                                                               
CN  PERLER                   Marie-Claire    DCI ACT -   MARICLAR@CERNVM.CERN.CH                                                            
CN  BUNN                     Julian          DCI DEC SL  julian@vxcern.cern.ch                                                              
CN  LING                     Lingdi          DCI DEC -   LLD@VXCERN.CERN.CH                                                                 
CN  DE-GENNARO               Silvano         DCI DEC -   SILVANO@VXCERN.CERN.CH                                                             
CN  WIEGANDT                 Dietrich        DCI DEC -   DIETRICH@dxcern.CERN.CH                                                            
CN  LETERTRE                 Christiane      DCI DEC -   LETERTRE@VXCERN.CERN.CH                                                            
CN  DODGSON                  Michael         DCI DI  -   DODGSON@CERNVM.CERN.CH                                                             
CN  JONES                    Chris           DCI DI  GL  CHRIS@CERNVM.CERN.CH                                                               
CN  NIELSEN                  Henrik          DCI GS  -   FRYSTYK@DXCERN.CERN.CH                                                             
CN  PEYRAT                   Alain           DCI GS  -   peyrat@dxcern.cern.ch                                                              
CN  SECRET                   Arthur          DCI GS  -   SECRET@DXCERN.CERN.CH                                                              
CN  WHIBLEY                  Tim             DCI GS  -   TIM@VXCERN.CERN.CH                                                                 
CN  RICHARDS                 Judy            DCI GS  SL  judy@cernvm.cern.ch                                                                
CN  JONES                    Peter           DCI GS  -   PETE@VXCERN.CERN.CH                                                                
CN  FROST-AINLEY             Lio             DCI GS  -   LFACT@CERNVM.CERN.CH                                                               
CN  DEFERT                   Philippe        DCI GS  -   DEFERT@dxcern.cern.ch                                                              
CN  BERNERS-LEE              Timothy         DCI GS  -   timbl@info.cern.ch                                                                 
CN  DOBROVICOVA              Ivica           DCI NCS -   IDOBRO@DXCERN.CERN.CH                                                              
CN  FOSTER                   David           DCI NCS SL  david@dxcern.CERN.CH                                                               
CN  HAGEN                    Per             DCI NCS -   hagen@smtpgw.msm.cern.ch                                                           
CN  CASS                     Tony            DCI UES SL  TNT@CERNVM.CERN.CH                                                                 
CN  TADDEI                   Arnaud          DCI UES -   TADDEI@DXCERN.CERN.CH                                                              
CN  BALL                     Christiane      DCI UWS -   CBAC3@CERNVM.CERN.CH                                                               
CN  SILVERMAN                Alan            DCI UWS DGL ALAN@VXCERN.CERN.CH                                                                
CN  REGUERO                  Ignacio         DCI UWS -   reguero@sunsoft.cern.ch                                                            
CN  GUIJARRO                 Juan-Manuel     DCI UWS -   GUIJARRO@VXCERN.CERN.CH                                                            
CN  LOVELL                   Alan            DCI UWS -   LOVELL@VXCERN.CERN.CH                                                              
CN  TOBBICKE                 Rainer          DCI UWS -   rtb@afsmail.cern.ch                                                                
CN  CONS                     Lionel          DCI UWS -   CONS@DXCERN.CERN.CH                                                                
CN  JACOBS                   David           DI  DI  DDL DJADJ@CERNVM.CERN.CH                                                               
CN  WILLIAMS                 David-Owen      DI  DI  DL  davidw@cernvm.cern.ch                                                              
CN  JUVET                    Jean-Claude     DI  DI  GL  jean-claude_juvet@macmail.cern.ch                                                  
CN  OUDE-MOLEMAN             Anna            DI  DI  -   AOMCT@CERNVM.CERN.CH                                                               
CN  VERKERK                  Rinus           DI  DI  -   VERKERK@CERNVM.CERN.CH                                                             
CN  TURNER                   Jackie          DI  DI  -   JACKIE@CERNVM.CERN.CH                                                              
CN  FAVROT                   Veronique       DI  SE  SL  VERO@CERNVM.CERN.CH                                                                
CN  VISMARA                  Ilse            DI  SE  -   VISMARA@CERNVM.CERN.CH                                                             
CN  PRODON                   Arlette         DI  SE  -   ARLETTE@CERNVM.CERN.CH                                                             
CN  THORNBOROUGH             Anna-Birgitta   DI  SE  -   BIRGITTA@CERNVM.CERN.CH                                                            
CN  HAUSER                   Reiner          GPM DI  -   RHAUSER@CERNVM.CERN.CH                                                             
CN  ASPOLA                   Kirsti          GPM DI  -   ASPOLA@VXCERN.CERN.CH                                                              
CN  BRUSCHINI                Claudio         GPM DI  -   CLAUDIOB@VXCERN.CERN.CH                                                            
CN  LEQUERICA-ZORROZUA       Irene           GPM DI  -   ireleq@dbsrv01.cern.ch                                                             
CN  BERTOLOTTO               Laura           GPM DI  -   laurab@cernvm.cern.ch                                                              
CN  HAKULINEN                Timo            GPM DI  -   THAKULIN@DXCERN.CERN.CH                                                            
CN  PANZER-STEINDEL          Bernd           GPM DI  -   PANZER@CERNVM.CERN.CH                                                              
CN  APOSTOLAKIS              John            GPM DI  -   JAPOST@CERNVM.CERN.CH                                                              
CN  MURALIDHARAN             Venkataraman    PDP CS  -   murali@sun2.cern.ch                                                                
CN  HASSINE                  Felix           PDP CS  -   acher@sun2.cern.ch                                                                 
CN  BOISSAT                  Christian       PDP CS  -   BOISSAT@DXCERN.CERN.CH                                                             
CN  VERGARI                  Mario           PDP CS  -   VNV@CERNVM.CERN.CH                                                                 
CN  PETTERSSON               Thomas-Sven     PDP CS  -   PET@CERNVM.CERN.CH                                                                 
CN  OLOFSSON                 Knut-Soren      PDP CS  -   SOREN@CERNAPO.CERN.CH                                                              
CN  LEE                      John-Gordon     PDP CS  -   GORDON@dxcern.CERN.CH                                                              
CN  JARP                     Sverre          PDP CS  -   SVERRE@CERNVM.CERN.CH                                                              
CN  HEMMER                   Frederic        PDP CS  SL  hemmer@sun2.cern.ch                                                                
CN  DORE                     Vincent         PDP CS  -   DORE@CERNVM.CERN.CH                                                                
CN  GOMEZ-HERRADON           Juan-Carlos     PDP DH  -   herradon@sun2.cern.ch                                                              
CN  SACLIER-D'ARQUIAN        Etienne         PDP DH  -   ESACLIER@SUN2.CERN.CH                                                              
CN  ANTOINE                  Bernard         PDP DH  -   BJAC3@CERNVM.CERN.CH                                                               
CN  ASBURY                   David           PDP DH  -   DAVID@CERNVM.CERN.CH                                                               
CN  GRANA-DOMINGUEZ          Santiago        PDP DH  -   SGRANA@CERNVM.CERN.CH                                                              
CN  SUMMERILL                Sharon          PDP DH  -   SHARON@CERNVM.CERN.CH                                                              
CN  APOSTOLOPOULOS           George          PDP DH  -   APOSTOL@CERNVM.cern.ch                                                             
CN  TRENEL                   Barbara         PDP DH  -   GHTC3@CERNVM.CERN.CH                                                               
CN  MCINTOSH                 Eric            PDP DH  SL  MCINTOSH@CERNVM.CERN.CH                                                            
CN  MAVER                    Antonio         PDP DH  -   ASMC3@CERNVM.CERN.CH                                                               
CN  BAUD                     Jean-Philippe   PDP DH  -   BAUD@CERNVM.CERN.CH                                                                
CN  SIMMINS                  Antony          PDP DI  -   None                                                                               
CN  FOSS                     Hilde           PDP DI  -   foss@dxcern.cern.ch                                                                
CN  MEGIES                   Jutta           PDP DI  -   MEGCM@CERNVM.CERN.CH                                                               
CN  ROBERTSON                Les             PDP DI  GL  les@ppe.msm.cern.ch                                                                
CN  EDSALL                   David           PDP DI  -   EDSALL@DXDE04.CERN.CH                                                              
CN  RENSHALL                 Harry           PDP DI  -   HRRCR@CERNVM.CERN.CH                                                               
CN  GAGLIARDI                Fabrizio        PDP DI  DGL FAB@VXCERN.CERN.CH                                                                 
CN  DUPRAZ                   Dominique-Suz.  PDP DI  -   DUPDOM@CERNVM.CERN.CH                                                              
CN  SEGAL                    Ben             PDP NS  SL  BEN@dxcern.CERN.CH                                                                 
CN  CURRAN                   Charles         PDP VM  SL  CSCCT@CERNVM.CERN.CH                                                               
CN  HOEJENBOS                Lenny           PDP VM  -   LHHCT@CERNVM.CERN.CH                                                               
CN  MINCHIN                  Richard         PDP VM  -   RPMCT@CERNVM.CERN.CH                                                               
